TTTTTTTTTTTTTTTTTTTTT
T           R       T
T  R                T
T       R           T
T                   .
T            R      T
T   R               T
T                   T
TTTTTTTTTTTTTTTTTTTTT